speech/stupid.wav	speech
speech/teachers2.wav	speech
speech/danie1.wav	speech
speech/oneday.wav	speech
speech/jvoice.wav	speech
speech/relation.wav	speech
speech/geography.wav	speech
speech/pulp2.wav	speech
speech/greek1.wav	speech
speech/conversion.wav	speech
speech/smoke1.wav	speech
speech/dialogue.wav	speech
speech/kid.wav	speech
speech/undergrad.wav	speech
speech/acomic2.wav	speech
speech/news2.wav	speech
speech/voices.wav	speech
speech/nj105a.wav	speech
speech/acomic.wav	speech
speech/jony.wav	speech
speech/psychic.wav	speech
speech/pulp1.wav	speech
speech/emil.wav	speech
speech/ellhnika.wav	speech
speech/bathroom1.wav	speech
speech/thlui.wav	speech
speech/nether.wav	speech
speech/diamond.wav	speech
speech/pulp.wav	speech
speech/vegetables.wav	speech
speech/greek.wav	speech
speech/serbian.wav	speech
speech/china.wav	speech
speech/smoking.wav	speech
speech/teachers.wav	speech
speech/voice.wav	speech
speech/vegetables2.wav	speech
speech/austria.wav	speech
speech/male.wav	speech
speech/fem_rock.wav	speech
speech/geography1.wav	speech
speech/comedy1.wav	speech
speech/nj105.wav	speech
speech/kedar.wav	speech
speech/comedy.wav	speech
speech/female.wav	speech
speech/dialogue1.wav	speech
speech/dialogue2.wav	speech
speech/charles.wav	speech
speech/shannon.wav	speech
speech/god.wav	speech
speech/vegetables1.wav	speech
speech/news1.wav	speech
speech/lena.wav	speech
speech/amal.wav	speech
speech/india.wav	speech
speech/allison.wav	speech
speech/teachers1.wav	speech
speech/danie.wav	speech
speech/chant.wav	speech
speech/sleep.wav	speech
speech/my_voice.wav	speech
speech/fire.wav	speech
speech/georg.wav	speech
music/ballad.wav	music
music/u2.wav	music
music/hendrix.wav	music
music/loreena.wav	music
music/narch.wav	music
music/moanin.wav	music
music/ncherry.wav	music
music/misirlou.wav	music
music/brahms.wav	music
music/jazz.wav	music
music/beat.wav	music
music/corea.wav	music
music/glass1.wav	music
music/birdland.wav	music
music/beatles.wav	music
music/georose.wav	music
music/jazz1.wav	music
music/nearhou.wav	music
music/classical1.wav	music
music/corea1.wav	music
music/ipanema.wav	music
music/opera.wav	music
music/madradeus.wav	music
music/unpoco.wav	music
music/led.wav	music
music/canonaki.wav	music
music/marlene.wav	music
music/russo.wav	music
music/gravity.wav	music
music/deedee1.wav	music
music/bartok.wav	music
music/magkas.wav	music
music/guitar.wav	music
music/eguitar.wav	music
music/caravan.wav	music
music/bigband.wav	music
music/march.wav	music
music/opera1.wav	music
music/chaka.wav	music
music/blues.wav	music
music/rock2.wav	music
music/winds.wav	music
music/copland.wav	music
music/bmarsalis.wav	music
music/classical.wav	music
music/rock.wav	music
music/tony.wav	music
music/vlobos.wav	music
music/gismonti.wav	music
music/debussy.wav	music
music/mingus.wav	music
music/pop.wav	music
music/glass.wav	music
music/cure.wav	music
music/deedee.wav	music
music/duke.wav	music
music/copland2.wav	music
music/gravity2.wav	music
music/redhot.wav	music
music/bagpipe.wav	music
music/mingus1.wav	music
music/classical2.wav	music
music/prodigy.wav	music
music/echoes.wav	music
